4800,20000,1,1,1020,10,0,0,0,
2,0,0,45,300,100,0,6,0,
3,0,0,45,300,100,0,7,0,
4,0,600,45,300,100,5,9,0,
15,0,300,45,300,100,5,8,0,
16,0,300,45,300,100,1,5,0,
6,0,450,450,900,100,1,6,0,
10,0,900,450,900,100,1,5,0,
16,0,1350,450,900,100,1,5,0,
13,1,300,1,1,100,0,0,0,
13,1,0,1,1,80,0,2,0,
13,1,0,1,1,60,0,4,0,
23,0,13500,13500,13500,100,9,9,0,
0,0,0,0,0,0,0,9,0,
0,0,0,0,0,0,0,9,0,
0,0,0,0,0,0,0,9,0,
0,0,0,0,0,0,0,9,0,
0,0,0,0,0,0,0,9,0,
0,0,0,0,0,0,0,9,0,
0,0,0,0,0,0,0,9,0,