4800,20000,1,1,2,5,0,0,0,
2,0,0,45,210,100,0,7,0,
3,0,0,45,210,100,0,7,0,
4,0,600,90,210,100,6,9,0,
17,0,1200,90,210,100,6,9,0,
8,0,1000,1000,1500,100,4,8,0,
10,0,1300,1000,1500,100,0,3,0,
7,0,1600,1000,1500,100,4,8,0,
8,3,0,1,1,80,4,8,0,
7,8,0,1,1,60,4,8,0,
10,4,0,1,1,40,0,6,0,
23,0,13500,13500,13500,100,9,9,0,
0,0,0,0,0,0,0,9,0,
0,0,0,0,0,0,0,9,0,
0,0,0,0,0,0,0,9,0,
0,0,0,0,0,0,0,9,0,
0,0,0,0,0,0,0,9,0,
0,0,0,0,0,0,0,9,0,
0,0,0,0,0,0,0,9,0,
0,0,0,0,0,0,0,9,0,
0,0,0,0,0,0,0,9,0,
