4800,15000,15,90,0,3,0,0,0,
5,0,0,150,600,90,0,4,0,
6,0,0,150,600,90,0,4,0,
7,0,0,150,600,90,4,9,0,
8,0,0,150,600,90,4,9,0,
8,1,2700,150,600,100,4,9,0,
7,1,1800,150,600,100,4,9,0,
6,1,900,150,600,100,0,4,0,
5,1,0,150,600,100,0,4,0,
23,0,13500,13500,13500,100,9,9,0,
0,0,0,0,0,0,0,9,0,
0,0,0,0,0,0,0,9,0,
0,0,0,0,0,0,0,9,0,
0,0,0,0,0,0,0,9,0,
0,0,0,0,0,0,0,9,0,
0,0,0,0,0,0,0,9,0,
0,0,0,0,0,0,0,9,0,
0,0,0,0,0,0,0,9,0,
0,0,0,0,0,0,0,9,0,
0,0,0,0,0,0,0,9,0,
0,0,0,0,0,0,0,9,0,
