4800,5000,10,15,1,12,0,0,0,
2,0,0,100,200,100,1,6,0,
3,0,300,100,200,100,1,6,0,
4,0,600,100,200,100,6,9,0,
4,6,0,30,60,90,6,9,0,
4,0,0,50,200,88,6,9,0,
7,1,0,100,200,90,6,6,0,
7,1,0,100,200,88,0,0,0,
23,0,13500,13500,13500,100,9,9,0,
0,0,0,0,0,0,0,9,0,
0,0,0,0,0,0,0,9,0,
0,0,0,0,0,0,0,9,0,
0,0,0,0,0,0,0,9,0,
0,0,0,0,0,0,0,9,0,
0,0,0,0,0,0,0,9,0,
0,0,0,0,0,0,0,9,0,
0,0,0,0,0,0,0,9,0,
0,0,0,0,0,0,0,9,0,
0,0,0,0,0,0,0,9,0,
0,0,0,0,0,0,0,9,0,
0,0,0,0,0,0,0,9,0,
