4800,4000,2,150,0,7,0,0,0,
2,0,0,160,280,100,0,6,0,
3,0,120,300,800,100,0,6,0,
4,0,600,150,600,100,6,9,0,
4,6,0,30,60,99,6,9,0,
6,1,0,15,30,98,0,0,0,
6,1,0,15,30,78,5,5,0,
23,0,13500,13500,13500,100,9,9,0,
0,0,0,0,0,0,0,9,0,
0,0,0,0,0,0,0,9,0,
0,0,0,0,0,0,0,9,0,
0,0,0,0,0,0,0,9,0,
0,0,0,0,0,0,0,9,0,
0,0,0,0,0,0,0,9,0,
0,0,0,0,0,0,0,9,0,
0,0,0,0,0,0,0,9,0,
0,0,0,0,0,0,0,9,0,
0,0,0,0,0,0,0,9,0,
0,0,0,0,0,0,0,9,0,
0,0,0,0,0,0,0,9,0,
0,0,0,0,0,0,0,9,0,
