6000,300000,1,1,1,8,0,0,0,
4,0,0,2,15,100,5,9,0,
15,0,300,4,20,100,3,7,0,
16,0,300,4,20,100,2,6,0,
8,0,0,100,300,99,1,4,0,
6,0,0,100,300,99,0,0,0,
12,0,0,200,900,100,1,4,0,
10,0,0,150,600,100,1,4,0,
24,0,600,900,1200,100,5,5,0,
4,0,0,10,30,99,5,9,0,
24,4,0,1,1,99,5,5,0,
12,6,0,1,60,99,1,4,0,
10,6,0,60,200,99,1,4,0,
8,10,0,1,20,99,1,4,0,
26,1,0,1,1,70,5,5,2,
23,0,13500,13500,13500,100,9,9,0,
0,0,0,0,0,0,0,9,0,
0,0,0,0,0,0,0,9,0,
0,0,0,0,0,0,0,9,0,
0,0,0,0,0,0,0,9,0,
0,0,0,0,0,0,0,9,0,
