4800,8000,2,15,2,10,0,0,0,
2,0,0,15,150,100,2,6,0,
3,0,0,15,150,100,2,6,0,
4,0,0,15,150,100,6,9,0,
7,1,1500,1,1,100,0,0,0,
6,0,2000,600,900,100,1,1,0,
7,0,2000,600,900,100,0,4,0,
7,1,0,15,30,60,0,0,0,
7,1,0,15,30,61,4,4,0,
7,1,0,15,30,60,2,2,0,
7,1,0,15,30,62,7,7,0,
23,0,13500,13500,13500,100,9,9,0,
0,0,0,0,0,0,0,9,0,
0,0,0,0,0,0,0,9,0,
0,0,0,0,0,0,0,9,0,
0,0,0,0,0,0,0,9,0,
0,0,0,0,0,0,0,9,0,
0,0,0,0,0,0,0,9,0,
0,0,0,0,0,0,0,9,0,
0,0,0,0,0,0,0,9,0,
0,0,0,0,0,0,0,9,0,
