4800,15000,15,150,3,8,0,0,0,
2,0,0,50,200,100,0,6,0,
3,0,150,100,400,100,0,6,0,
4,0,300,180,720,100,4,9,0,
15,0,600,300,1200,100,4,9,0,
9,0,900,380,1520,50,0,3,0,
8,0,1200,450,900,100,4,9,0,
10,0,1800,450,900,100,2,4,0,
23,0,13500,13500,13500,100,9,9,0,
0,0,0,0,0,0,0,9,0,
0,0,0,0,0,0,0,9,0,
0,0,0,0,0,0,0,9,0,
0,0,0,0,0,0,0,9,0,
0,0,0,0,0,0,0,9,0,
0,0,0,0,0,0,0,9,0,
0,0,0,0,0,0,0,9,0,
0,0,0,0,0,0,0,9,0,
0,0,0,0,0,0,0,9,0,
0,0,0,0,0,0,0,9,0,
0,0,0,0,0,0,0,9,0,
0,0,0,0,0,0,0,9,0,
									