4300,100000,1,1,2,12,0,0,0,
4,0,0,2,15,100,5,9,0,
15,0,0,90,500,100,3,7,0,
17,0,0,90,1000,100,2,6,0,
15,0,1200,4,20,100,3,7,0,
17,0,1800,4,20,100,2,6,0,
7,0,0,200,900,100,1,4,0,
5,0,0,150,600,100,1,4,0,
25,1,0,1,1,100,0,0,2,
23,0,13500,13500,13500,100,9,9,0,
13,0,600,1000,1500,100,5,5,0,
0,0,0,0,0,0,0,9,0,
0,0,0,0,0,0,0,9,0,
0,0,0,0,0,0,0,9,0,
0,0,0,0,0,0,0,9,0,
0,0,0,0,0,0,0,9,0,
0,0,0,0,0,0,0,9,0,
0,0,0,0,0,0,0,9,0,
0,0,0,0,0,0,0,9,0,
0,0,0,0,0,0,0,9,0,
0,0,0,0,0,0,0,9,0,
