3600,6100,15,45,0,4,0,0,0,
2,0,0,15,150,100,2,7,0,
3,0,300,150,300,100,2,7,0,
4,0,600,300,600,100,6,9,0,
4,8,300,10,30,99,6,9,0,
6,1,2000,600,900,100,0,0,0,
5,1,4200,600,900,100,1,1,0,
6,1,900,1,1,100,0,0,0,
5,1,1200,1,1,100,1,1,0,
23,0,13500,13500,13500,100,9,9,0,
0,0,0,0,0,0,0,9,0,
0,0,0,0,0,0,0,9,0,
0,0,0,0,0,0,0,9,0,
0,0,0,0,0,0,0,9,0,
0,0,0,0,0,0,0,9,0,
0,0,0,0,0,0,0,9,0,
0,0,0,0,0,0,0,9,0,
0,0,0,0,0,0,0,9,0,
0,0,0,0,0,0,0,9,0,
0,0,0,0,0,0,0,9,0,
0,0,0,0,0,0,0,9,0,
