5000,7000,2,150,0,10,0,0,0,
2,0,0,15,150,100,1,7,0,
3,0,0,15,150,100,1,7,0,
4,0,0,15,150,100,6,9,0,
7,1,1500,1,1,100,0,0,0,
7,1,1530,1,1,100,4,4,0,
6,0,2000,600,900,100,3,3,0,
5,0,2000,600,900,100,1,1,0,
7,1,0,1,1,20,0,0,0,
7,1,0,1,1,20,4,4,0,
23,0,13500,13500,13500,100,9,9,0,
0,0,0,0,0,0,0,9,0,
0,0,0,0,0,0,0,9,0,
0,0,0,0,0,0,0,9,0,
0,0,0,0,0,0,0,9,0,
0,0,0,0,0,0,0,9,0,
0,0,0,0,0,0,0,9,0,
0,0,0,0,0,0,0,9,0,
0,0,0,0,0,0,0,9,0,
0,0,0,0,0,0,0,9,0,
0,0,0,0,0,0,0,9,0,
