4000,99999,1,1,1,4,0,0,0,
4,0,0,15,30,100,9,9,0,
5,0,0,100,200,100,2,5,0,
7,0,0,150,300,100,5,8,0,
8,0,700,200,450,100,5,8,0,
12,0,1800,450,750,100,1,1,0,
20,1,0,1,1,100,0,0,2,
23,0,13500,13500,13500,100,9,9,0,
0,0,0,0,0,0,0,9,0,
0,0,0,0,0,0,0,9,0,
0,0,0,0,0,0,0,9,0,
0,0,0,0,0,0,0,9,0,
0,0,0,0,0,0,0,9,0,
0,0,0,0,0,0,0,9,0,
0,0,0,0,0,0,0,9,0,
0,0,0,0,0,0,0,9,0,
0,0,0,0,0,0,0,9,0,
0,0,0,0,0,0,0,9,0,
0,0,0,0,0,0,0,9,0,
0,0,0,0,0,0,0,9,0,
0,0,0,0,0,0,0,9,0,
