6000,10000,2,60,3,8,0,0,0,
30,0,600,30,600,100,4,9,0,
32,1,100,10,10,100,6,6,0,
31,1,100,0,300,100,0,0,0,
30,2,0,30,450,100,6,9,0,
23,1,3000,300,300,100,9,9,0,
18,4,3870,30,120,100,0,8,0,
31,1,300,0,300,100,8,8,0,
0,0,0,0,0,0,0,9,0,
0,0,0,0,0,0,0,9,0,
0,0,0,0,0,0,0,9,0,
0,0,0,0,0,0,0,9,0,
0,0,0,0,0,0,0,9,0,
0,0,0,0,0,0,0,9,0,
0,0,0,0,0,0,0,9,0,
0,0,0,0,0,0,0,9,0,
0,0,0,0,0,0,0,9,0,
0,0,0,0,0,0,0,9,0,
0,0,0,0,0,0,0,9,0,
0,0,0,0,0,0,0,9,0,
0,0,0,0,0,0,0,9,0,
