6000,15000,2,150,0,10,0,0,0,
3,0,150,75,100,100,1,9,0,
4,0,300,100,150,100,1,9,0,
15,0,600,150,300,100,1,9,0,
9,0,900,150,300,100,0,0,0,
8,0,2400,450,900,100,4,9,0,
10,0,3000,450,900,100,4,6,0,
7,0,1200,450,900,100,4,9,0,
5,0,1800,450,900,100,0,3,0,
6,0,1800,450,900,100,0,3,0,
23,0,13500,13500,13500,100,9,9,0,
0,0,0,0,0,0,0,9,0,
0,0,0,0,0,0,0,9,0,
0,0,0,0,0,0,0,9,0,
0,0,0,0,0,0,0,9,0,
0,0,0,0,0,0,0,9,0,
0,0,0,0,0,0,0,9,0,
0,0,0,0,0,0,0,9,0,
0,0,0,0,0,0,0,9,0,
0,0,0,0,0,0,0,9,0,
0,0,0,0,0,0,0,9,0,
