4800,20000,15,90,2,10,0,0,0,
2,0,0,60,200,100,1,7,0,
3,0,200,60,200,100,2,8,0,
4,0,900,60,200,100,6,9,0,
15,0,1200,150,300,100,5,8,0,
16,0,1500,150,300,100,1,8,0,
12,1,0,1,1,99,0,0,1,
23,0,13500,13500,13500,100,9,9,0,
0,0,0,0,0,0,0,9,0,
0,0,0,0,0,0,0,9,0,
0,0,0,0,0,0,0,9,0,
0,0,0,0,0,0,0,9,0,
0,0,0,0,0,0,0,9,0,
0,0,0,0,0,0,0,9,0,
0,0,0,0,0,0,0,9,0,
0,0,0,0,0,0,0,9,0,
0,0,0,0,0,0,0,9,0,
0,0,0,0,0,0,0,9,0,
0,0,0,0,0,0,0,9,0,
0,0,0,0,0,0,0,9,0,
0,0,0,0,0,0,0,9,0,










