4800,18000,15,60,3,8,0,0,0,
4,0,0,50,200,100,7,9,0,
16,0,300,30,150,100,1,8,0,
10,0,900,300,600,100,3,5,0,
6,0,600,300,600,0,3,5,0,
16,0,0,30,150,99,0,9,0,
16,0,600,30,150,100,1,8,0,
6,1,0,1,1,100,6,6,0,
23,0,13500,13500,13500,100,9,9,0,
0,0,0,0,0,0,0,9,0,
0,0,0,0,0,0,0,9,0,
0,0,0,0,0,0,0,9,0,
0,0,0,0,0,0,0,9,0,
0,0,0,0,0,0,0,9,0,
0,0,0,0,0,0,0,9,0,
0,0,0,0,0,0,0,9,0,
0,0,0,0,0,0,0,9,0,
0,0,0,0,0,0,0,9,0,
0,0,0,0,0,0,0,9,0,
0,0,0,0,0,0,0,9,0,
0,0,0,0,0,0,0,9,0,
									