4800,20000,15,45,0,4,0,0,0,
2,0,0,50,150,100,0,7,0,
3,0,200,50,150,100,0,7,0,
4,0,100,50,150,100,6,9,0,
15,0,1200,50,150,100,6,9,0,
16,0,1500,50,200,100,1,8,0,
9,0,1500,50,300,100,3,7,0,
5,0,1800,300,600,100,1,5,0,
6,0,1800,300,600,100,1,5,0,
12,1,1500,1,1,100,0,0,0,
12,1,2500,1,1,100,0,0,0,
23,0,13500,13500,13500,100,9,9,0,
0,0,0,0,0,0,0,9,0,
0,0,0,0,0,0,0,9,0,
0,0,0,0,0,0,0,9,0,
0,0,0,0,0,0,0,9,0,
0,0,0,0,0,0,0,9,0,
0,0,0,0,0,0,0,9,0,
0,0,0,0,0,0,0,9,0,
0,0,0,0,0,0,0,9,0,
0,0,0,0,0,0,0,9,0,
									