4800,15000,2,150,3,5,0,0,0,
2,0,0,15,150,100,0,6,0,
3,0,150,15,150,100,0,6,0,
4,0,300,15,30,100,4,9,0,
5,1,600,15,15,100,0,0,0,
9,0,0,65,120,50,0,4,0,
7,0,0,65,120,50,0,9,0,
23,0,13500,13500,13500,100,9,9,0,
0,0,0,0,0,0,0,9,0,
0,0,0,0,0,0,0,9,0,
0,0,0,0,0,0,0,9,0,
0,0,0,0,0,0,0,9,0,
0,0,0,0,0,0,0,9,0,
0,0,0,0,0,0,0,9,0,
0,0,0,0,0,0,0,9,0,
0,0,0,0,0,0,0,9,0,
0,0,0,0,0,0,0,9,0,
0,0,0,0,0,0,0,9,0,
0,0,0,0,0,0,0,9,0,
0,0,0,0,0,0,0,9,0,
0,0,0,0,0,0,0,9,0,
